                   ╭─────────────────────────────────────────────┬─────────╮
                   │ ☙ ☙                                        ╭╯☙ ☙ ☙ ☙  │
                   ╰─────────╮                                 ╭╯          │
                             │          ╭──────────────╮     ╭─╯           │
                 ╭──╮        ╰──────────╯              ╰╮                  │
         ╭───────╯  │                                   ╰╮   ╰╮☙           │
         │          │         ╭──────╮                   │    ╰╮☙          │
         │          │         │ ☙  ☙ │                   │     ╰╮☙         │
         │  ╭───╮   │         │   ☙  │                   │      ╰╮☙        │
╭────────┤    ☙ │   │         │      │                   │       ╰╮☙       │
│ ☙ ☙ ☙  │    ☙ │   │         │      │                   │        ╰───╮    │
│        │ ╭────╯   │         │      │                   │☙ ☙         │    │
│        │ │   ☙ ☙  │         │      ╰─┬──────────╮      ╰──╮         │    │
│        │ │ ☙ ☙    │         │        │          │         │         │    │
│        │ ╰────────╯         │            ☙ ☙ ☙  │         │         │    │
│        │                   ╭╯            ☙ ☙ ☙  │         │         │    │
│        │                  ╭╯         │          ├───╮     ╰─────────╯    │
│        │     ╭───╮       ╭╯          ╰──────────╯   ╰╮                   │
│        │     │   │      ╭╯                           ╰╮                  │
│        │     │   │     ╭╯    ╭─────────────────────╮  ╰╮  ╭─────────╯    │
│      ╭─╯     │   │ ☙ ☙ │    ╭╯                     │   ╰╮ │              │
│      │       │   ╰─────╯   ╭╯                      │    ╰╮│              │
│      │       │            ╭╯                             ╰╯              │
│      │ ☙ ☙ ☙ │           ╭╯                                              │
│      ╰───────╯          ╭╯                                               │
│                        ╭╯                         │       │              │
│                       ╭╯                          │ ☙ ☙ ☙ │              │
╰───────────────────────┴───────────────────────────╯       ╰──────────────╯