^^^`*`````````````````````````
^^``*```````````````````~~~```
^```***````````***````~~~`````
^````**```````*```*````~``````
^`*``**```````*``**`````````*`
^`*``**```````*``*``````````*`
^`*****`````░░*``*````^^````*`
^````**````░░░**``*``^^^^`````
^````**```░░░``**`*````~^^^```
`^^``````░░░```^***```~~``````
`^^``````░░```^^`````~````````
`^^```````````````````````````
`^^```````````````````````````
^^^```````````````````````````
^^````**`````░░░````````~~~```
^^``***``````░█░``***`░░░`````
^```░░░░░````░█░``***`░░░`````
^```░░░░░````░█░``**░`░█░```*`
*```░███░````░█░```*░`░█░```*`
**``░███░````░░░```*░░░█░```**
***`░███░``````````*░░░█░````*
``*`░░░░░``````^^^`░░░░█░````*
``*`░░░░░``````^^^`░░░░█░`````
`***``````````^^^^``░░░█░`````
``*```````````^^^^````░░░`````
``````````````^^^^````````````