                   ╭─────────────────────────────────────────────┬─────────╮
                   │ ☙☙                                         ╭╯  ☙☙☙☙   │
                   ╰─────────╮                                 ╭╯          │
                             │          ╭──────────────╯     ╭─╯           │
                 ╭──┐        ╰──────────╯                ╭───┤  ☙☙☙        │
         ╭───────╯  │                                    │   ╰╮            │
         │          │         ╭──────╮                   │    ╰╮           │
         │          │         │ ☙☙☙  │                   │     ╰╮          │
         │      │   │         │      │                   │      ╰╮         │
╭────────┤      │   │         │      │                           ╰╮ ☙☙     │
│ ☙☙☙    │      │   │         │      │                      ╭──   ╰───╮    │
│        │ ╭────╯   │         │      │                   │  │         │    │
│        │ │   ☙☙☙  │         │      ╰─┬──────────╮      ╰──┤         │    │
│        │ │   ☙☙☙  │         │        │          │         │         │    │
│        │ ╰────────╯         │            ☙☙☙    │         │         │    │
│        │                   ╭╯            ☙☙☙    │         │         │    │
│        │                  ╭╯        │           ├───╮     ╰─────────┤    │
│        │                 ╭╯         ╰───────────╯   ╰╮              │    │
│        │                ╭╯                           ╰╮             │    │
│        │               ╭┴─────────────────────────╮   ╰╮  ╭─────────╯    │
├──   ───╯               │                          │    ╰╮ │              │
│                        │                          │     ╰╮│              │
│                        │                                 ╰╯              │
│                        │                                                 │
│                                                                          │
│                                                   │       │              │
│                        │                          │  ☙☙☙  │              │
╰────────────────────────┴──────────────────────────╯       ╰──────────────╯