^^                      ~~~     ^^                      ~~~     
^    **        ***    ~~~       ^    **        ***    ~~~       
^    **       *   *    ~         ^    **       *   *    ~       
^    **       *  **         *    ^    **       *  **         *  
^    **       *  *          *   ^    **       *  *          *   
^    **     ░░*  *    ^^    *   ^    **     ░░*  *    ^^    *   
^    **    ░░░**  *  ^^^^       ^    **    ░░░**  *  ^^^^       
^    **   ░░░  ** *    ~^^^     ^    **   ░░░  ** *    ~^^^     
 ^^      ░░░   ^***   ~~         ^^      ░░░   ^***   ~~        
 ^^      ░░   ^^     ~           ^^      ░░   ^^     ~    ◠     
 ^^                              ^^                       ◡     
 ^^          ⬠⬠₪             †   ^^          ⬠⬠₪             †  
^^^    **                       ^^^    **                       
^^    **     ░░░        ~~~     ^^    **     ░░░        ~~~     
^^  ***      ░█░  *** ░░░       ^^  ***      ░█░  *** ░░░       
^   ░░░░░    ░█░  *** ░░░       ^   ░░░░░    ░█░  *** ░░░       
^   ░░░░░    ░█░  **░ ░█░   *   ^   ░░░░░    ░█░  **░ ░█░   *   
*   ░███░    ░█░   *░ ░█░   *   *   ░███░    ░█░   *░ ░█░   *   
**  ░███░    ░░░   *░░░█░   **  **  ░███░    ░░░   *░░░█░   **  
*** ░███░          *░░░█░    *  *** ░███░          *░░░█░    *  
  * ░░░░░      ^^^ ░░░░█░    *    * ░░░░░      ^^^ ░░░░█░    *  
  * ░░░░░      ^^^ ░░░░█░         * ░░░░░      ^^^ ░░░░█░       
 ***          ^^^^  ░░░█░        ***          ^^^^  ░░░█░       
  *           ^^^^    ░░░         *           ^^^^    ░░░       
              ^^^^         ☙          ╭─╮     ^^^^              
             †^^^^                      │     †^^^^             
             †^^^^                    ╰─╯     †^^^^             
             †^^^^       ▁                    †^^^^             