                                                                 
 ^^``````````````````````~~~`````^^``````````````````````~~~`````
 ^````**````````***````~~~```````^````**````````***````~~~```````
 ^````**```````*```*````~```````` ^````**```````*```*````~```````
 ^````**```````*``**`````````*``` ^````**```````*``**`````````*``
 ^````**```````*``*``````````*```^````**```````*``*``````````*```
 ^````**`````░░*``*````^^````*```^````**`````░░*``*````^^````*```
 ^````**````░░░**``*``^^^^```````^````**````░░░**``*``^^^^```````
 ^````**```░░░``**`*````~^^^`````^````**```░░░``**`*````~^^^`````
 `^^``````░░░```^***```~~`````````^^``````░░░```^***```~~````````
 `^^``````░░```^^`````~```````````^^``````░░```^^`````~``````````
 `^^``````````````````````````````^^`````````````````````````````
 `^^``````````⬠⬠₪`````````````†```^^``````````⬠⬠₪`````````````†``
 ^^^````**```````````````````````^^^````**```````````````````````
 ^^````**`````░░░````````~~~`````^^````**`````░░░````````~~~`````
 ^^``***``````░█░``***`░░░```````^^``***``````░█░``***`░░░```````
 ^```░░░░░````░█░``***`░░░```````^```░░░░░````░█░``***`░░░```````
 ^```░░░░░````░█░``**░`░█░```*```^```░░░░░````░█░``**░`░█░```*```
 *```░███░````░█░```*░`░█░```*```*```░███░````░█░```*░`░█░```*```
 **``░███░````░░░```*░░░█░```**``**``░███░````░░░```*░░░█░```**``
 ***`░███░``````````*░░░█░````*``***`░███░``````````*░░░█░````*``
 ``*`░░░░░``````^^^`░░░░█░````*````*`░░░░░``````^^^`░░░░█░````*``
 ``*`░░░░░``````^^^`░░░░█░`````````*`░░░░░``````^^^`░░░░█░```````
 `***``````````^^^^``░░░█░````````***``````````^^^^``░░░█░```````
 ``*```````````^^^^````░░░`````````*```````````^^^^````░░░```````
 ``````````````^^^^````````````````````````````^^^^``````````````
 `````````````†^^^^```````````````````````````†^^^^``````````````
 `````````````†^^^^```````````````````````````†^^^^``````````````
 `````````````†^^^^```````````````````````````†^^^^``````````````