﻿                   ╭─────────────────────────────────────────────┬─────────╮ 
                    │ ☙ ☙                                        ╭╯         │
                    ╰─────────╮                                 ╭╯          │
                              │          ╭──────────────╮     ╭─╯           │
                  ╭──╮        ╰──────────╯              ╰╮                  │
          ╭───────╯  │                                   ╰╮   ╰╮            │
          │          │         ╭──────╮                   │    ╰╮           │
          │          │         │ ☙  ☙ │                   │     ╰╮          │
          │  ╭───╮   │         │   ☙  │                   │      ╰╮         │
 ╭────────┤    ☙ │   │         │      │                   │       ╰╮        │
 │        │    ☙ │   │         │      │                   │        ╰───╮    │
 │        │ ╭────╯   │         │      │                   │☙ ☙         │    │
 │        │ │        │         │      ╰─┬──────────╮      ╰──╮         │    │
 │        │ │        │         │        │          │         │         │    │
 │        │ ╰────────╯         │                   │         │         │    │
 │        │                   ╭╯                   │         │         │    │
 │        │                  ╭╯         │          ├───╮ ☙   ╰─────────╯    │
 │        │     ╭───╮       ╭╯          ╰──────────╯   ╰╮                   │
 │        │     │   │      ╭╯                           ╰╮                  │
 │        │     │   │     ╭╯    ╭─────────────────────╮  ╰╮  ╭─────────╯    │
 │      ╭─╯     │   │ ☙ ☙ │    ╭╯                     │   ╰╮ │              │
 │      │       │   ╰─────╯   ╭╯                      │    ╰╮│              │
 │      │       │            ╭╯                             ╰╯              │
 │      │       │           ╭╯                                              │
 │      ╰───────╯          ╭╯                                               │
 │                        ╭╯                         │       │              │
 │                       ╭╯                          │       │              │
 ╰───────────────────────┴───────────────────────────╯       ╰──────────────╯