╭─────────────────────╮ ☙  ☙ ☙      ╭────────────────────────────┬─────────╮
│                     ╰──────╮      ╰╮  ☙                       ╭╯☙     ☙  │
│                            │   ╭╯  ╰╮                        ╭╯          │
│            ╭   ╭───────────╯  ╭╯    ╰╮        ╭╮    ╭╮     ╭─╯           │
│           ╭╯  ╭╯              ╰╮     ╰╮      ╭╯╰╮  ╭╯╰╮                  │
│          ╭╯  ╭╯                ╰╮     ╰╮    ╭╯ ☙╰╮╭╯ ☙╰╮   ╰╮☙           │
│         ╭╯  ╭╯                  ╰╮  ☙  ╰╮☙☙╭╯    ╰╯    │    ╰╮           │
│        ╭╯  ╭╯ ☙   ╭╮            ╭┴╮     ╰╮ ╰╮       ╭╮ ╰╮    ╰╮☙         │
│       ╭╯   ╰──╮   │╰╮          ╭╯ ╰╮     ╰╮ ╰╮     ╭╯╰╮☙╰╮    ╰╮         │
│       ╰╮   ☙  │   │ ╰╮        ╭╯   ╰╮     ╰╮ ╰╮    │  ╰╮╭╯     ╰╮☙       │
│        │   ☙  │   │  ╰╮      ╭╯     ╰╮ ☙   ╰╮ ╰╮   │   ╰╯       ╰───╮    │
│        │ ╭────╯   │   ╰╮ ☙☙ ╭╯       ╰╮     ╰╮☙╰╮  │                │    │
│        │ │        │    ╰╮  ╭╯         ╰─╮   ─╯  │  │                │    │
│        │ │        │     ╰╮╭╯           ╭╯       │  │       │        │    │
│        │ ╰─      ─╯      ╰╯ ╭╮         │           │       │        │    │
│        │                   ╭╯╰╮        │           │       │      ☙ │    │
│        │                  ╭╯☙ ╰╮       │           ├──╮    ╰────────╯    │
│        │     ╭───╮       ╭╯    ╰╮      ╰───────────╯  ╰╮                 │
│        │     │   │      ╭╯      ╰╮                     ╰╮                │
│        │     │   │     ╭╯        ╰─────   ─────────╮    ╰╮☙ ╭─────────╯  │
│      ╭─╯     │   │ ☙ ☙ │    ╭╮                     │     ╰╮ │            │
│      │       │   ╰─────╯   ╭╯╰╮                    │      ╰╮│            │
│      │       │            ╭╯☙☙╰╮                           ╰╯            │
│      │ ☙ ☙ ☙ │           ╭╯    ╰╮                                        │
│      ╰───────╯          ╭╯      │                                        │
│                        ╭╯       ╰──────   ────────╮       │              │
│                       ╭╯                        ☙ │       │              │
╰───────────────────────┴───────────────────────────╯       ╰──────────────╯